10 10
00 01 01 01 01 01 01 01 01 02
03 04 04 04 04 04 04 04 04 05
03 04 04 04 04 04 04 04 04 05
03 04 04 04 04 04 04 04 04 05
03 04 04 04 04 04 04 04 04 05
03 04 04 04 04 04 04 04 04 05
03 04 04 04 04 04 04 04 04 05
03 04 04 04 04 04 04 04 04 05
03 04 04 04 04 04 04 04 04 05
06 07 07 07 07 07 07 07 07 08
